"filename", "language", "cpp", "CMake", "comment", "blank", "total"
"/home/oysterpus/IP/src/CMakeLists.txt", "CMake", 0, 6, 4, 3, 13
"/home/oysterpus/IP/src/base/network.cpp", "cpp", 31, 0, 1, 5, 37
"/home/oysterpus/IP/src/base/network.hpp", "cpp", 40, 0, 0, 10, 50
"/home/oysterpus/IP/src/base/packet.cpp", "cpp", 22, 0, -6, 1, 17
"/home/oysterpus/IP/src/base/packet.hpp", "cpp", 3, 0, 2, -1, 4
"/home/oysterpus/IP/src/base/packet_client.cpp", "cpp", 11, 0, 1, 0, 12
"/home/oysterpus/IP/src/base/protobuf_addon.hpp", "cpp", 18, 0, 1, 0, 19
"/home/oysterpus/IP/src/client/client.cpp", "cpp", 15, 0, 11, 1, 27
"/home/oysterpus/IP/src/client/client.hpp", "cpp", 15, 0, 2, 0, 17
"/home/oysterpus/IP/src/example/test_client.cpp", "cpp", 17, 0, 2, 3, 22
"/home/oysterpus/IP/src/example/test_server.cpp", "cpp", 11, 0, 0, 2, 13
"/home/oysterpus/IP/src/server/server.cpp", "cpp", 95, 0, 10, 8, 113
"/home/oysterpus/IP/src/server/server.hpp", "cpp", 27, 0, 1, 5, 33
"/home/oysterpus/IP/src/server/thread_pool.hpp", "cpp", 49, 0, 0, 6, 55
"Total", "-", 354, 6, 29, 43, 432