"filename", "language", "CMake", "cpp", "protobuf", "comment", "blank", "total"
"/home/oysterpus/IP/CMakeLists.txt", "CMake", 6, 0, 0, 5, 4, 15
"/home/oysterpus/IP/proto/CMakeLists.txt", "CMake", 8, 0, 0, 0, 1, 9
"/home/oysterpus/IP/proto/action.proto", "protobuf", 0, 0, 62, 3, 15, 80
"/home/oysterpus/IP/proto/element.proto", "protobuf", 0, 0, 71, 0, 16, 87
"/home/oysterpus/IP/proto/packet.proto", "protobuf", 0, 0, 10, 0, 2, 12
"/home/oysterpus/IP/src/CMakeLists.txt", "CMake", 21, 0, 0, 13, 12, 46
"/home/oysterpus/IP/src/base/element.cpp", "cpp", 0, 0, 0, 0, 1, 1
"/home/oysterpus/IP/src/base/element.hpp", "cpp", 0, 17, 0, 0, 5, 22
"/home/oysterpus/IP/src/base/network.cpp", "cpp", 0, 31, 0, 1, 5, 37
"/home/oysterpus/IP/src/base/network.hpp", "cpp", 0, 40, 0, 0, 10, 50
"/home/oysterpus/IP/src/base/packet.cpp", "cpp", 0, 43, 0, 4, 6, 53
"/home/oysterpus/IP/src/base/packet.hpp", "cpp", 0, 39, 0, 22, 6, 67
"/home/oysterpus/IP/src/base/packet_client.cpp", "cpp", 0, 22, 0, 4, 4, 30
"/home/oysterpus/IP/src/base/protobuf_addon.hpp", "cpp", 0, 18, 0, 1, 0, 19
"/home/oysterpus/IP/src/base/utils.cpp", "cpp", 0, 37, 0, 6, 9, 52
"/home/oysterpus/IP/src/client/client.cpp", "cpp", 0, 35, 0, 18, 8, 61
"/home/oysterpus/IP/src/client/client.hpp", "cpp", 0, 43, 0, 7, 8, 58
"/home/oysterpus/IP/src/example/test_client.cpp", "cpp", 0, 17, 0, 2, 3, 22
"/home/oysterpus/IP/src/example/test_server.cpp", "cpp", 0, 11, 0, 0, 2, 13
"/home/oysterpus/IP/src/server/server.cpp", "cpp", 0, 102, 0, 11, 10, 123
"/home/oysterpus/IP/src/server/server.hpp", "cpp", 0, 27, 0, 1, 5, 33
"/home/oysterpus/IP/src/server/thread_pool.hpp", "cpp", 0, 49, 0, 0, 6, 55
"Total", "-", 35, 531, 143, 98, 138, 945